NO ./sprites/doc.xpm
SO ./sprites/mater.xpm
WE ./sprites/mcqueen.xpm
EA ./sprites/max.xpm


F 255,0,0
C 6,22,39

                  11111111111111111111111111111
                 1000000000000000100000000000001
                100000000000000001000000000000001
               10000000000000000010000000000000001
              1000000000000000000100000000000000001
1111111111111111000000000000000001000000000000000111111111111111
100000000000000000000000000000000000000000000000000000000000010011
1000000000000000000000000000000000000000000000000000000000000011111
100000000000000000000000000000000E0000000000000000000000000000000001
100000000000000000000000000000000000000000000000000000000000000000001
1000000000000000000000000000000000000000000000000000000000000000000001
10000000000000000000000000000000000000000000000000000000000000000000001
100000000000000000000000000000000000000000000000000000000000000000000001
11111111111111111111111111111111111111111111111111111111111111111111111
         11111111                                    11111111          
          111111                                      111111            
           1111                                        1111