NO ./sprites/planks.xpm
SO ./sprites/purplestone.xpm
WE ./sprites/wall_lvl4.xpm
EA ./sprites/wood.xpm
DO ./sprites/door_good.xpm

F 125,107,87
C 6,22,39

1111111111111111111111111111111111111
1000100010001000100010001000100010001
1000D000D000D000D000D000D000D000D0001
1000100010001000100010001000100010001
11D111D111D111D111D111D111D111D111D11
1000100010001000100010001000100010001
1000D000D000D000D000D000D000D000D0001
1000100010001000100010001000100010001
11D111D111D111D111D111D111D111D111D11
1000100010001000100010001000100010001
1000D000D000D000D000D000D000D000D0001
1000100010001000100010001000100010001
11D111D111D111D111D111D111D111D111D11
1000100010001000100010001000100010001
1000D000D000D000D0N0D000D000D000D0001
1000100010001000100010001000100010001
11D111D111D111D111D111D111D111D111D11
1000100010001000100010001000100010001
1000D000D000D000D000D000D000D000D0001
1000100010001000100010001000100010001
11D111D111D111D111D111D111D111D111D11
1000100010001000100010001000100010001
1000D000D000D000D000D000D000D000D0001
1000100010001000100010001000100010001
11D111D111D111D111D111D111D111D111D11
1000100010001000100010001000100010001
1000D000D000D000D000D000D000D000D0001
1000100010001000100010001000100010001
1111111111111111111111111111111111111