NO ./sprites/planks.xpm
SO ./sprites/purplestone.xpm
WE ./sprites/wall_lvl4.xpm
EA ./sprites/wood.xpm
DO ./sprites/door_metal.xpm
F 125,107,87
C 6,22,39

             11111
             10001
             10S01
             10001
111111111111111D111111111111111
1000100010100010001000001000001
1010101010101010101010101011101
1010100010001000101010001010101
1010111010111011101011101010101
1010000010000000100010001010101
1110111011101110111110111010101
1000101000001000100000000010101
1011101011101011101110101110101
1010001000101000100010100010101
1010111110101111101011101011101
1000000010100000001010001000001
1110101110101111111010111011101
1000101000001010000010001000101
1011101111101010111111111011101
1000100010000010000000010000101
1110101110111110111110111011101
1010000000000010001000001010001
1011111111101011101111111010111
1000001000001010000000010000101
1111101011111011111010111011101
1000001001000000100010001000101
1011111011101110110111101011101
1000000001000100010100001000001
1111111111111111111111D11111111
                    10001
                    10001
                    10001
                    11111