NO ./sprites/planks.xpm
SO ./sprites/purplestone.xpm
WE ./sprites/wall_lvl4.xpm
EA ./sprites/wood.xpm
DO ./sprites/door_good.xpm

F 125,107,87
C 6,22,39

        1111111111111111111111111
        1000000000110000000000001
        1011000001110000000000001
        1001000000000000000000001
111111111011000001110000000000001
10000000001100000111D110000111111
11110111111111011100000010001
11110111111111011101010010001
11000000110101011100000000001
10000000000000000D00000000001
10000000000000001101010000001
1100000111010101111101111N00111
11110111 1110101 101111010001
11111111 1111111 111111111111