NO ./sprites/planks.xpm
SO ./sprites/purplestone.xpm
WE ./sprites/wall_lvl4.xpm
EA ./sprites/wood.xpm
DO ./sprites/door_metal.xpm

F 125,107,87
C 6,22,39

1111111111111111111111111111111111111111111111111111111111111111111111111111111111111111111111
1000000000000000000000000000000000000000001000000000000000000100000000001000000000000000000001
10000000000000000000000000000011111111111D1111111D1111111111D1111111111D1110000000000000000001
1111100000000000000000000000000000000000000000000000000000000000000000000000000000000000000001
1000000000000000000000000000000000000000000000000000000000000000000000000010000000000000000001
1000000000000000000000000000000000000000000000000000000000000000000000000010000000000000000001
10000000000000000000000000000000000000000000000000000000000000000000000000101D10001D1000100001
100000000000000000000000000000000000000000000000000000000000000000000000001011111D11101D101D11
1000000000000000000000000000000000000000000000000000000000000000000000000011D110001D1100100011
10000000000000000000000000000000000000000000000000000000000000000000000000100001D10000D101D101
1000000000000000000000000000000000000000000000000000000000000000000000000011D110001D1111D10011
10000000000000000000000000000000000000000000000000000000000000000000000000100001D1001D10101D11
1000000000000000000000000000000000000000000000000000000000000000000000000011D11001D10001D10001
1000000000000000000000000000000000000000000000000000000000000000000000000010001D10001D10000D11
1000000000000000000000000000000000000000000000000000000000000000000000000011D10001D10001D10001
1000000000000000000000000000000000000000000000000000000000000000000000000010001D10001D10001D11
1000000000000000000000000000000000000000000000000000000000000000000000000011D10101D10101D10001
1000000000000000000000000000000000100000000000000000000000000000000000000010001D00001D10001D11
1000000000000000000000000000000000D00000000000000000000000000000000000000011D10001D00001D00001
1000000000000000000000000000000000100000000000000000000000000000000000000010001D10101D10001D11
1000000000000000000000000000000000000000000000000000000000000000000000000011D10001D10001D00001
1000000000000000000000000000000000000000000000000000000000000000000000000010001D10001D10001D11
1000000000000000000000000000000000000000000000000000000000000000000000000011D10001D10001D11101
1000000000000000000000000000000000000000000000000000000000000000000000000010001D10001D10101D11
1000000000000000000000000000000000000000000000000000000000000000000000000011D10001D10001D11111
1000000000000000000000000000000000000000000000000000000000000000000000000010001D10001D10001D11
1000000000000000000000000000000000000000000000000000000000000000000000000011D10001D10000D00001
1000000000000000000000000000000000000000000000000000000000000000000000000010001D10001D10011D11
1000000000000000000000000000000000000000000000000000000000000000000000000011D10001D10001D10001
1000000000000000000000000000000000000000000000000000000000000000000000000010001D10001D10001D11
1000000000000000000000000000000000000000000000000000000000000000000000000011D10001D10001D10001
1000000000000000000000000000000000000000000000000000000000000000000000000010001D10001D10001D11
1000000000000000000000000000000000000000000000000000000000000000000000000011D10001D10001D10001
1000000000000000000000000000000000000000000000000000000000000000000000000010001D10001D11111D11
1000000000000000000000000000000000000000000000000000000000000000000000000011D10001D10001D00001
1000000000000000000000000000000000000000000000000000000000000000000000000010001D10001D11011D11
1000000000000000000000000000000000000000000000000000000000000000000000000011D10001D10001D10001
1000000000000000000000000000000000000000000000000000000000000000000000D00010001D10001D10001D11
1000000000000000000000000000000000000000000000000000000000000000000000000111D10001D10001D10001
1000000000000000000000000000111111111111111111111100000111111000000000000011111111111111N11111
111111111111111111111111111111111 111111111111111111111111 11111111111111111111111111111111111