NO ./sprites/planks.xpm
SO ./sprites/purplestone.xpm
WE ./sprites/wall_lvl4.xpm
EA ./sprites/wood.xpm
DO ./sprites/door_good.xpm

F 87,93,39
C 125,107,87

11111111111111111111                                      111111111111111111111
10000000000000000101                                      100000000000000000001
10000000000000000001                                      100100011110000000001
11111110011000001101                                      100000000000001111011
11000000000000100001                                      100000000000000000001
11111111111111111D111111111111111111111111111111111111111111D111111111111111111
                1000000000000000000000000000000000000000000001
                1000000000000000000000000000000000000000000001
                1111111100000000000000000000000001111000000001
                1110000000000010000000000110000000000000110001
                10000000000000D0010000000000000000110000000111
                1000000000000010000000000000111111100001111111
                1000000000100011110000001111000000000000000001
                10000000000000000000011D1000000000000000010111
                10000000000000000000000000000000N0000000000001
                1000000000000000000010000000000000000000000001
                1111111111111111111111111111111111111111111111