NO ./sprites/planks.xpm
SO ./sprites/purplestone.xpm
WE ./sprites/wall_lvl4.xpm
EA ./sprites/wood.xpm
DO ./sprites/door_metal.xpm
F 125,107,87
C 6,22,39

1111111111111111111111111111111111111111
1000000000000000000000000000000000000001
1011111111111111111111111111111111111101
1010000000000000000000000000000000000101
1010111111111111111111111111111111010101
1010100000000000000000000000000001010101
1010101111111111111111111111111101010101
1010101000000000000000000000000101010101
1010101011111111111111111111100101010101
1010101010000000000000000000100001010101
1010101010111111111111111100000100000001
101010101000000000N000000000100101010101
1010101010101111111111100100100101010101
1010101010101000000000100100100101010101
1010101010101011111100100100100101010101
1010101010101010000100100100100101010101
1010101010101010110100100100100101010101
1010101010101010100100100100100101010101
1010101010101010100100100100100001010101
1010101010101010101111111111111101010101
1010101010101000000000000000000001010101
1010101010101111111111111111111101010101
1010101010000000000000000000000101010101
1010101011111111111111111111100101010101
1010101000000000000000000000100101010101
1010111111111111111111111100100101010101
1010000000000000000000000100100101010101
1011111111111111111111100100100101010101
1000000000000000000000100100100101010101
1011111111111111111100100100100101010101
1010000000000000000100100100100101010101
1010111111111111100100100100100101010101
1010000000000000100100100100100101010101
1011111111111100100100100100100101010101
1000000000000100100100100100100101010101
1011111111100100100100100100100101010101
1010000000100100100100100100100101010101
1010111110100100100100100100100101010101
1010000010010010010010010010010101010101
1111111111111111111111111111111111111111